TYPE  PX PY PZ SX SY DX DY HP DMG 
1,24,8,0,8,8,0,1,1,0
1,32,8,0,8,8,0,1,1,0
1,40,8,0,8,8,0,1,1,0
1,48,8,0,8,8,0,1,1,0
1,56,8,0,8,8,0,1,1,0
1,64,8,0,8,8,0,1,1,0
1,72,8,0,8,8,0,1,1,0
1,80,8,0,8,8,0,1,1,0
1,0,8,0,8,8,0,1,1,0
1,16,8,0,8,8,0,1,1,0
1,88,8,0,8,8,0,1,1,0
1,104,8,0,8,8,0,1,1,0
1,112,8,0,8,8,0,1,1,0
1,120,8,0,8,8,0,1,1,0
1,128,8,0,8,8,0,1,1,0
1,144,8,0,8,8,0,1,1,0
1,136,8,0,8,8,0,1,1,0
1,152,8,0,8,8,0,1,1,0
1,8,8,0,8,8,0,1,1,0
1,80,8,0,8,8,0,1,1,0
1,168,8,0,8,8,0,1,1,0
1,176,8,0,8,8,0,1,1,0
1,184,8,0,8,8,0,1,1,0
1,192,8,0,8,8,0,1,1,0
1,200,8,0,8,8,0,1,1,0
1,216,8,0,8,8,0,1,1,0
1,208,8,0,8,8,0,1,1,0
1,224,8,0,8,8,0,1,1,0
1,96,8,0,8,8,0,1,1,0
1,176,8,0,8,8,0,1,1,0
1,248,8,0,8,8,0,1,1,0
1,256,8,0,8,8,0,1,1,0
1,264,8,0,8,8,0,1,1,0
1,272,8,0,8,8,0,1,1,0
1,280,8,0,8,8,0,1,1,0
1,288,8,0,8,8,0,1,1,0
1,296,8,0,8,8,0,1,1,0
1,304,8,0,8,8,0,1,1,0
1,160,8,0,8,8,0,1,1,0
1,240,8,0,8,8,0,1,1,0
1,328,8,0,8,8,0,1,1,0
1,336,8,0,8,8,0,1,1,0
1,344,8,0,8,8,0,1,1,0
1,352,8,0,8,8,0,1,1,0
1,352,8,0,8,8,0,1,1,0
1,352,8,0,8,8,0,1,1,0
1,360,8,0,8,8,0,1,1,0
1,368,8,0,8,8,0,1,1,0
1,232,8,0,8,8,0,1,1,0
1,320,8,0,8,8,0,1,1,0
1,392,8,0,8,8,0,1,1,0
1,400,8,0,8,8,0,1,1,0
1,408,8,0,8,8,0,1,1,0
1,416,8,0,8,8,0,1,1,0
1,424,8,0,8,8,0,1,1,0
1,440,8,0,8,8,0,1,1,0
1,424,8,0,8,8,0,1,1,0
1,432,8,0,8,8,0,1,1,0
1,312,8,0,8,8,0,1,1,0
1,384,8,0,8,8,0,1,1,0
1,456,8,0,8,8,0,1,1,0
1,472,8,0,8,8,0,1,1,0
1,480,8,0,8,8,0,1,1,0
1,496,8,0,8,8,0,1,1,0
1,488,8,0,8,8,0,1,1,0
1,496,8,0,8,8,0,1,1,0
1,512,8,0,8,8,0,1,1,0
1,504,8,0,8,8,0,1,1,0
1,376,8,0,8,8,0,1,1,0
1,464,8,0,8,8,0,1,1,0
1,536,8,0,8,8,0,1,1,0
1,560,8,0,8,8,0,1,1,0
1,552,8,0,8,8,0,1,1,0
1,544,8,0,8,8,0,1,1,0
1,568,8,0,8,8,0,1,1,0
1,576,8,0,8,8,0,1,1,0
1,592,8,0,8,8,0,1,1,0
1,584,8,0,8,8,0,1,1,0
1,448,8,0,8,8,0,1,1,0
1,528,8,0,8,8,0,1,1,0
1,624,8,0,8,8,0,1,1,0
1,616,8,0,8,8,0,1,1,0
1,632,8,0,8,8,0,1,1,0
1,640,8,0,8,8,0,1,1,0
1,648,8,0,8,8,0,1,1,0
1,656,8,0,8,8,0,1,1,0
1,664,8,0,8,8,0,1,1,0
5,18.6832,24,0,10,10,0,1,20,1
1,520,8,0,8,8,0,1,1,0
1,608,8,0,8,8,0,1,1,0
1,0,16,0,8,8,0,1,20,1
1,0,24,0,8,8,0,1,1,0
1,0,32,0,8,8,0,1,1,0
1,0,40,0,8,8,0,1,1,0
1,48,16,0,8,8,0,1,1,0
1,56,16,0,8,8,0,1,1,0
9,105.167,22,1,5,5,0,1,5,5
1,120,16,0,8,8,0,1,20,1
1,600,8,0,8,8,0,1,1,0
1,0,16,0,8,8,0,1,20,1
1,136,16,0,8,8,0,1,1,0
1,136,24,0,8,8,0,1,1,0
1,144,16,0,8,8,0,1,1,0
1,144,24,0,8,8,0,1,1,0
1,152,16,0,8,8,0,1,1,0
1,152,24,0,8,8,0,1,1,0
1,152,32,0,8,8,0,1,1,0
1,160,8,0,8,8,0,1,1,0
1,128,16,0,8,8,0,1,20,1
1,136,8,0,8,8,0,1,1,0
8,238.845,23.8333,1,5,5,0,1,5,5
7,47.6493,35.8333,1,5,5,0,1,10,3
1,256,16,0,8,8,0,1,20,1
1,256,24,0,8,8,0,1,20,1
1,256,32,0,8,8,0,1,1,0
9,308.427,22.9983,1,5,5,0,1,5,5
5,349.895,23.3986,0,10,10,0,1,20,1
9,388.298,25.7319,1,5,5,0,0,5,5
1,160,16,0,8,8,0,1,1,0
1,160,32,0,8,8,0,1,1,0
3,416,24,0,8,8,0,1,20,1
3,424,16,0,8,8,0,1,1,0
3,424,24,0,8,8,0,1,1,0
3,424,16,0,8,8,0,1,1,0
3,432,16,0,8,8,0,1,1,0
3,432,24,0,8,8,0,1,1,0
3,448,32,0,8,8,0,1,1,0
3,456,32,0,8,8,0,1,1,0
1,160,24,0,8,8,0,1,1,0
3,416,16,0,8,8,0,1,20,1
3,488,40,0,8,8,0,1,1,0
3,496,40,0,8,8,0,1,1,0
3,504,40,0,8,8,0,1,1,0
8,580.838,47.266,1,5,5,0,1,5,5
3,512,40,0,8,8,0,1,5,5
3,520,40,0,8,8,0,1,20,1
3,528,32,0,8,8,0,1,20,1
3,464,32,0,8,8,0,1,10,3
3,472,32,0,8,8,0,1,20,1
3,480,40,0,8,8,0,1,20,1
3,576,32,0,8,8,0,1,1,0
3,584,32,0,8,8,0,1,1,0
3,592,32,0,8,8,0,1,1,0
1,736,8,0,8,8,0,1,1,0
10,631.98,24.1289,1,5,5,0,1,5,5
1,672,8,0,8,8,0,1,20,1
1,680,8,0,8,8,0,1,20,1
3,536,32,0,8,8,0,1,1,0
3,544,32,0,8,8,0,1,1,0
3,568,32,0,8,8,0,1,1,0
1,712,8,0,8,8,0,1,1,0
1,728,8,0,8,8,0,1,1,0
1,720,8,0,8,8,0,1,1,0
1,808,8,0,8,8,0,1,1,0
1,744,8,0,8,8,0,1,1,0
1,752,8,0,8,8,0,1,1,0
1,760,8,0,8,8,0,1,1,0
3,552,40,0,8,8,0,1,1,0
1,696,8,0,8,8,0,1,1,0
1,704,8,0,8,8,0,1,1,0
2,752,40,0,8,8,0,1,10,3
1,792,8,0,8,8,0,1,20,1
1,792,8,0,8,8,0,1,20,1
2,776,40,0,8,8,0,1,1,0
1,816,8,0,8,8,0,1,1,0
1,824,8,0,8,8,0,1,1,0
1,832,8,0,8,8,0,1,1,0
1,688,8,0,8,8,0,1,1,0
1,776,8,0,8,8,0,1,1,0
1,784,8,0,8,8,0,1,1,0
2,760,32,0,8,8,0,1,1,0
2,760,40,0,8,8,0,1,1,0
2,768,40,0,8,8,0,1,1,0
2,736,40,0,8,8,0,1,1,0
2,784,40,0,8,8,0,1,1,0
2,792,40,0,8,8,0,1,1,0
2,792,16,0,8,8,0,1,1,0
1,768,8,0,8,8,0,1,1,0
2,760,16,0,8,8,0,1,1,0
2,792,32,0,8,8,0,1,1,0
2,744,40,0,8,8,0,1,1,0
2,736,32,0,8,8,0,1,1,0
2,736,16,0,8,8,0,1,1,0
2,736,48,0,8,8,0,1,1,0
2,744,48,0,8,8,0,1,1,0
2,760,48,0,8,8,0,1,1,0
2,768,48,0,8,8,0,1,1,0
1,840,8,0,8,8,0,1,1,0
1,800,8,0,8,8,0,1,1,0
2,792,24,0,8,8,0,1,1,0
6,812.601,23.7668,0,10,10,0,1,10,3
1,840,16,0,8,8,0,1,20,1
1,840,24,0,8,8,0,1,20,1
8,201.845,25,1,5,5,0,1,5,5
3,560,40,0,8,8,0,1,1,0
1,680,16,0,8,8,0,1,20,1
1,840,32,0,8,8,0,1,1,0
1,840,40,0,8,8,0,1,1,0
2,784,48,0,8,8,0,1,1,0
2,792,48,0,8,8,0,1,1,0
1,840,48,0,8,8,0,1,1,0
11,557.861,22.3333,1,5,5,0,0,5,5
10,748.752,22.1667,1,5,5,0,1,5,5
1,680,24,0,8,8,0,1,20,1
1,680,32,0,8,8,0,1,1,0
9,660.411,21.5,1,5,5,0,1,5,5
11,780.238,21.6667,1,5,5,0,0,1,0
10,499.291,53.1497,1,5,5,0,1,5,5
