TYPE  PX PY PZ SX SY DX DY HP DMG 
1,56,-24,0,8,8,0,1,1,0
1,64,-24,0,8,8,0,1,1,0
1,0,-24,0,8,8,0,1,1,0
1,8,-24,0,8,8,0,1,1,0
1,16,-24,0,8,8,0,1,1,0
1,24,-24,0,8,8,0,1,1,0
1,24,-24,0,8,8,0,1,1,0
1,40,-24,0,8,8,0,1,1,0
1,32,-24,0,8,8,0,1,1,0
1,48,-24,0,8,8,0,1,1,0
1,120,-16,0,8,8,0,1,1,0
1,120,-8,0,8,8,0,1,1,0
1,72,-24,0,8,8,0,1,20,1
7,6.72881,-6.67453,1,5,5,0,1,10,3
1,80,-24,0,8,8,0,1,20,1
1,88,-24,0,8,8,0,1,20,1
1,96,-24,0,8,8,0,1,1,0
1,104,-24,0,8,8,0,1,1,0
1,112,-24,0,8,8,0,1,1,0
1,120,-24,0,8,8,0,1,20,1
1,160,-8,0,8,8,0,1,10,3
1,168,-8,0,8,8,0,1,1,0
1,128,-8,0,8,8,0,1,1,0
1,128,-16,0,8,8,0,1,1,0
1,128,-24,0,8,8,0,1,1,0
1,136,-24,0,8,8,0,1,10,3
1,136,-16,0,8,8,0,1,5,5
1,136,-8,0,8,8,0,1,5,5
1,144,-8,0,8,8,0,1,1,0
1,152,-8,0,8,8,0,1,10,3
1,216,-32,0,8,8,0,1,1,0
1,224,-32,0,8,8,0,1,10,3
1,176,-8,0,8,8,0,1,1,0
1,184,-8,0,8,8,0,1,1,0
1,192,-8,0,8,8,0,1,1,0
1,200,-8,0,8,8,0,1,1,0
1,208,-8,0,8,8,0,1,1,0
1,208,-16,0,8,8,0,1,1,0
1,208,-32,0,8,8,0,1,1,0
1,208,-24,0,8,8,0,1,1,0
1,352,-32,0,8,8,0,1,5,5
1,360,-32,0,8,8,0,1,1,0
1,232,-32,0,8,8,0,1,1,0
1,280,-16,0,8,8,0,1,1,0
1,288,-16,0,8,8,0,1,1,0
1,296,-16,0,8,8,0,1,1,0
1,304,-16,0,8,8,0,1,1,0
1,312,-16,0,8,8,0,1,1,0
1,336,-32,0,8,8,0,1,1,0
1,344,-32,0,8,8,0,1,5,5
1,416,-16,0,8,8,0,1,5,5
1,496,-32,0,8,8,0,1,1,0
1,424,-16,0,8,8,0,1,1,0
1,432,-16,0,8,8,0,1,1,0
1,448,-16,0,8,8,0,1,1,0
1,440,-16,0,8,8,0,1,1,0
1,456,-16,0,8,8,0,1,1,0
1,464,-16,0,8,8,0,1,1,0
1,472,-16,0,8,8,0,1,1,0
1,408,-16,0,8,8,0,1,1,0
1,576,-32,0,8,8,0,1,10,3
1,568,-32,0,8,8,0,1,1,0
1,504,-32,0,8,8,0,1,20,1
1,512,-32,0,8,8,0,1,5,5
1,520,-32,0,8,8,0,1,1,0
1,528,-32,0,8,8,0,1,1,0
1,536,-32,0,8,8,0,1,1,0
1,552,-32,0,8,8,0,1,1,0
1,544,-32,0,8,8,0,1,1,0
1,560,-32,0,8,8,0,1,10,3
10,470.272,-3.3412,1,5,5,0,1,5,5
11,546.769,-15.0226,1,5,5,0,1,5,5
1,584,-32,0,8,8,0,1,5,5
1,592,-32,0,8,8,0,1,1,0
1,600,-32,0,8,8,0,1,1,0
1,608,-32,0,8,8,0,1,1,0
8,161.026,8.82547,1,5,5,0,1,5,5
8,190.327,9.99213,1,5,5,0,1,5,5
11,301.068,-3.50787,1,5,5,0,0,5,5
9,353.436,-19.6745,1,5,5,0,1,5,5
1,632,-40,0,8,8,0,1,1,0
1,640,-40,0,8,8,0,1,1,0
8,581.911,-19.0079,1,5,5,0,0,5,5
1,624,-40,0,8,8,0,1,1,0
1,624,-48,0,8,8,0,1,1,0
1,624,-56,0,8,8,0,1,1,0
1,624,-64,0,8,8,0,1,1,0
1,632,-64,0,8,8,0,1,1,0
1,632,-56,0,8,8,0,1,1,0
1,632,-48,0,8,8,0,1,1,0
1,656,-40,0,8,8,0,1,1,0
1,656,-48,0,8,8,0,1,1,0
1,640,-48,0,8,8,0,1,1,0
1,640,-56,0,8,8,0,1,1,0
1,640,-64,0,8,8,0,1,1,0
1,648,-64,0,8,8,0,1,1,0
1,648,-64,0,8,8,0,1,1,0
1,648,-48,0,8,8,0,1,1,0
1,648,-56,0,8,8,0,1,1,0
1,648,-40,0,8,8,0,1,1,0
1,672,-56,0,8,8,0,1,1,0
1,760,-8,0,8,8,0,1,1,0
1,656,-56,0,8,8,0,1,1,0
1,656,-64,0,8,8,0,1,1,0
1,664,-64,0,8,8,0,1,1,0
1,664,-56,0,8,8,0,1,1,0
1,664,-48,0,8,8,0,1,1,0
1,664,-40,0,8,8,0,1,1,0
1,672,-48,0,8,8,0,1,1,0
1,672,-40,0,8,8,0,1,1,0
1,688,-64,0,8,8,0,1,1,0
1,696,-64,0,8,8,0,1,1,0
1,672,-64,0,8,8,0,1,1,0
1,680,-64,0,8,8,0,1,1,0
1,680,-56,0,8,8,0,1,1,0
1,680,-48,0,8,8,0,1,1,0
1,680,-40,0,8,8,0,1,1,0
1,688,-40,0,8,8,0,1,1,0
1,688,-48,0,8,8,0,1,1,0
1,688,-56,0,8,8,0,1,1,0
1,712,-40,0,8,8,0,1,1,0
1,712,-48,0,8,8,0,1,1,0
1,696,-56,0,8,8,0,1,1,0
1,696,-48,0,8,8,0,1,1,0
1,696,-40,0,8,8,0,1,1,0
1,704,-40,0,8,8,0,1,1,0
1,704,-48,0,8,8,0,1,1,0
1,704,-56,0,8,8,0,1,1,0
1,704,-64,0,8,8,0,1,1,0
1,272,-16,0,8,8,0,1,1,0
1,728,-56,0,8,8,0,1,1,0
1,728,-64,0,8,8,0,1,1,0
1,712,-56,0,8,8,0,1,1,0
1,712,-64,0,8,8,0,1,1,0
1,720,-64,0,8,8,0,1,1,0
1,720,-56,0,8,8,0,1,1,0
1,720,-48,0,8,8,0,1,1,0
1,720,-40,0,8,8,0,1,1,0
1,728,-40,0,8,8,0,1,1,0
1,728,-48,0,8,8,0,1,1,0
1,752,-64,0,8,8,0,1,1,0
1,752,-56,0,8,8,0,1,1,0
1,736,-64,0,8,8,0,1,1,0
1,736,-56,0,8,8,0,1,1,0
1,736,-48,0,8,8,0,1,1,0
1,736,-40,0,8,8,0,1,1,0
1,744,-40,0,8,8,0,1,1,0
1,744,-56,0,8,8,0,1,1,0
1,744,-48,0,8,8,0,1,1,0
1,744,-64,0,8,8,0,1,1,0
11,694.944,-27.7876,1,5,5,0,1,5,5
10,715.298,-27.296,1,5,5,0,1,5,5
1,752,-48,0,8,8,0,1,1,0
1,760,-48,0,8,8,0,1,1,0
1,752,-40,0,8,8,0,1,1,0
1,760,-40,0,8,8,0,1,1,0
1,760,-56,0,8,8,0,1,1,0
1,760,-64,0,8,8,0,1,1,0
1,672,-32,0,8,8,0,1,1,0
1,680,-32,0,8,8,0,1,1,0
1,776,-48,0,8,8,0,1,1,0
1,776,-40,0,8,8,0,1,1,0
1,784,-40,0,8,8,0,1,1,0
5,643.694,-24.5428,0,10,10,0,1,20,1
1,768,-40,0,8,8,0,1,20,1
1,768,-48,0,8,8,0,1,20,1
1,768,-56,0,8,8,0,1,1,0
1,768,-64,0,8,8,0,1,1,0
1,776,-64,0,8,8,0,1,1,0
1,776,-56,0,8,8,0,1,1,0
1,800,-48,0,8,8,0,1,1,0
1,800,-56,0,8,8,0,1,1,0
1,784,-48,0,8,8,0,1,1,0
1,784,-56,0,8,8,0,1,1,0
1,784,-64,0,8,8,0,1,1,0
1,792,-64,0,8,8,0,1,1,0
1,792,-56,0,8,8,0,1,1,0
1,792,-48,0,8,8,0,1,1,0
1,792,-40,0,8,8,0,1,1,0
1,800,-40,0,8,8,0,1,1,0
1,800,-24,0,8,8,0,1,1,0
1,800,-32,0,8,8,0,1,1,0
1,768,-8,0,8,8,0,1,1,0
1,800,-64,0,8,8,0,1,1,0
1,760,-16,0,8,8,0,1,1,0
1,768,-16,0,8,8,0,1,1,0
1,776,-16,0,8,8,0,1,1,0
1,784,-16,0,8,8,0,1,1,0
1,792,-16,0,8,8,0,1,1,0
1,800,-16,0,8,8,0,1,1,0
1,568,-40,0,8,8,0,1,1,0
1,560,-40,0,8,8,0,1,1,0
1,544,-40,0,8,8,0,1,1,0
1,536,-40,0,8,8,0,1,1,0
1,552,-40,0,8,8,0,1,5,5
1,600,-40,0,8,8,0,1,1,0
1,608,-40,0,8,8,0,1,1,0
1,592,-40,0,8,8,0,1,1,0
1,584,-40,0,8,8,0,1,1,0
1,576,-40,0,8,8,0,1,1,0
1,784,-8,0,8,8,0,1,1,0
1,792,-8,0,8,8,0,1,1,0
1,800,-8,0,8,8,0,1,1,0
1,840,-32,0,8,8,0,1,1,0
1,528,-40,0,8,8,0,1,1,0
1,512,-40,0,8,8,0,1,1,0
1,520,-40,0,8,8,0,1,1,0
1,504,-40,0,8,8,0,1,1,0
1,496,-40,0,8,8,0,1,1,0
1,776,-8,0,8,8,0,1,1,0
1,848,-32,0,8,8,0,1,1,0
1,856,-32,0,8,8,0,1,1,0
1,864,-32,0,8,8,0,1,1,0
1,872,-32,0,8,8,0,1,1,0
1,904,-48,0,8,8,0,1,1,0
1,912,-48,0,8,8,0,1,1,0
1,920,-48,0,8,8,0,1,1,0
1,928,-48,0,8,8,0,1,1,0
8,789.401,18.4347,1,5,5,0,1,5,5
8,860.168,-15.9037,1,5,5,0,1,5,5
1,960,-32,0,8,8,0,1,1,0
1,984,-48,0,8,8,0,1,1,0
1,992,-48,0,8,8,0,1,1,0
1,1000,-48,0,8,8,0,1,1,0
1,1008,-48,0,8,8,0,1,1,0
1,1016,-48,0,8,8,0,1,1,0
1,1024,-48,0,8,8,0,1,1,0
1,1032,-48,0,8,8,0,1,1,0
1,944,-32,0,8,8,0,1,1,0
1,952,-32,0,8,8,0,1,1,0
1,1056,-48,0,8,8,0,1,1,0
1,1032,-40,0,8,8,0,1,1,0
1,1032,-32,0,8,8,0,1,1,0
1,1064,-48,0,8,8,0,1,1,0
1,1072,-48,0,8,8,0,1,1,0
1,1080,-48,0,8,8,0,1,1,0
1,1088,-48,0,8,8,0,1,1,0
1,1096,-48,0,8,8,0,1,1,0
1,1040,-48,0,8,8,0,1,1,0
1,1048,-48,0,8,8,0,1,1,0
1,1104,-48,0,8,8,0,1,20,1
1,1104,-40,0,8,8,0,1,20,1
1,1104,-32,0,8,8,0,1,1,0
1,1104,-24,0,8,8,0,1,1,0
1,1104,-16,0,8,8,0,1,1,0
1,1104,-8,0,8,8,0,1,1,0
1,1104,0,0,8,8,0,1,1,0
6,1090.81,-31.8919,0,10,10,0,1,10,3
1,984,-56,0,8,8,0,1,1,0
9,1055.34,-29.0813,1,5,5,0,1,5,5
1,1000,-56,0,8,8,0,1,1,0
1,1008,-56,0,8,8,0,1,1,0
1,1016,-56,0,8,8,0,1,1,0
1,1024,-56,0,8,8,0,1,1,0
1,1032,-56,0,8,8,0,1,1,0
1,1040,-56,0,8,8,0,1,1,0
1,1048,-56,0,8,8,0,1,1,0
1,1056,-56,0,8,8,0,1,1,0
1,1064,-56,0,8,8,0,1,1,0
1,992,-56,0,8,8,0,1,1,0
1,1080,-56,0,8,8,0,1,1,0
1,1088,-56,0,8,8,0,1,1,0
1,1096,-56,0,8,8,0,1,1,0
1,1104,-56,0,8,8,0,1,1,0
1,1072,-56,0,8,8,0,1,1,0
