TYPE  PX PY PZSX SY DX DY 
4,80,32,0,8,8,0,1
4,88,32,0,8,8,0,1
4,96,32,0,8,8,0,1
4,104,32,0,8,8,0,1
4,112,32,0,8,8,0,1
4,40,32,0,8,8,0,1
4,48,32,0,8,8,0,1
4,56,32,0,8,8,0,1
4,64,32,0,8,8,0,1
4,72,32,0,8,8,0,1
4,152,32,0,8,8,0,1
4,160,32,0,8,8,0,1
4,144,32,0,8,8,0,1
11,80,40,1,5,5,0,1
11,96,40,1,5,5,0,1
10,56,56,1,5,5,0,1
4,112,32,0,8,8,0,1
4,120,32,0,8,8,0,1
4,136,32,0,8,8,0,1
4,128,32,0,8,8,0,1
11,112,40,1,5,5,0,1
