TYPE  PX PY PZSX SY DX DY 
4,48,32,0,8,8,0,1
4,56,32,0,8,8,0,1
4,64,32,0,8,8,0,1
4,72,32,0,8,8,0,1
4,88,32,0,8,8,0,1
4,96,32,0,8,8,0,1
4,104,32,0,8,8,0,1
4,80,32,0,8,8,0,1
4,112,32,0,8,8,0,1
4,40,32,0,8,8,0,1
4,96,40,0,8,8,0,1
4,72,32,0,8,8,0,1
4,96,40,0,8,8,0,1
4,104,40,0,8,8,0,1
10,43.5,47.1667,1,5,5,0,1
4,112,40,0,8,8,0,1
4,112,64,0,8,8,0,1
4,96,64,0,8,8,0,1
4,104,64,0,8,8,0,1
12,109.667,75.2361,1,5,5,0,1
14,97.5,75.9028,1,5,5,0,1
13,112.333,51.7361,1,5,5,0,1
11,99,51.9028,1,5,5,0,1
