TYPE  PX PY PZ SX SY DX DY HP DMG 
1,40,32,0,8,8,0,1,1,0
1,40,32,0,8,8,0,1,1,0
1,48,32,0,8,8,0,1,1,0
1,48,32,0,8,8,0,1,1,0
1,56,32,0,8,8,0,1,1,0
1,64,32,0,8,8,0,1,1,0
1,80,32,0,8,8,0,1,1,0
1,88,32,0,8,8,0,1,1,0
1,96,32,0,8,8,0,1,1,0
1,112,32,0,8,8,0,1,1,0
1,112,32,0,8,8,0,1,1,0
1,104,32,0,8,8,0,1,1,0
6,55.8333,47.6667,1,5,5,0,1,10,3
1,72,32,0,8,8,0,1,1,0
