TYPE  PX PY PZSX SY DX DY 

4,96,32,0,8,8,0,1
4,104,32,0,8,8,0,1
4,80,32,0,8,8,0,1
4,112,32,0,8,8,0,1
4,40,32,0,8,8,0,1
4,48,32,0,8,8,0,1
4,56,32,0,8,8,0,1
4,64,32,0,8,8,0,1
4,72,32,0,8,8,0,1

