TYPE  PX PY PZSX SY DX DY 
4,104,32,0,8,8,0,1,1,1
4,48,32,0,8,8,0,1,1,1
4,56,32,0,8,8,0,1,1,1
4,40,32,0,8,8,0,1,1,1
4,32,32,0,8,8,0,1,1,1
4,80,32,0,8,8,0,1,1,1
4,64,32,0,8,8,0,1,1,1
4,72,32,0,8,8,0,1,1,1
4,88,32,0,8,8,0,1,1,1
4,96,32,0,8,8,0,1,1,1
10,30.3333,46.6667,1,5,5,0,1,20,1
11,61.5,43,1,5,5,0,1,10,3
13,80.5,44.1667,1,5,5,0,1,5,5
4,112,32,0,8,8,0,1,1,1
4,120,32,0,8,8,0,1,1,1
4,24,32,0,8,8,0,1,1,1
