TYPE  PX PY PZSX SY DX DY 
4,56,32,0,8,8,0,1
4,64,32,0,8,8,0,1
4,72,32,0,8,8,0,1
4,80,32,0,8,8,0,1
4,88,32,0,8,8,0,1
4,96,32,0,8,8,0,1
4,104,32,0,8,8,0,1
4,112,32,0,8,8,0,1
4,40,32,0,8,8,0,1
4,48,32,0,8,8,0,1
4,128,32,0,8,8,0,1
4,152,32,0,8,8,0,1
4,160,32,0,8,8,0,1
4,144,32,0,8,8,0,1
4,144,40,0,8,8,0,1
4,144,48,0,8,8,0,1
10,56,56,1,5,5,0,1
4,152,40,0,8,8,0,1
4,120,32,0,8,8,0,1
4,136,32,0,8,8,0,1
13,113.833,43.6667,1,5,5,0,1
11,93.1667,44.1667,1,5,5,0,1
4,152,48,0,8,8,0,1
